1111111111111111111111111111111111
10N0000N1000000C10000C00000000N001
1010010110100000E11001000N00010101
1010010010101010N01001000P00010111
100000001C00C0000000000000000000C1
1111111111111111111111111111111111