1111111111111
10010000000C1
1000000111N01
1P0011E000001
1111111111111