1
11
101
1001
1E001
100001
100C001
1P000001
111111111